NO wall_rendering/FLOOR_2A.xpm

SO wall_rendering/FLOOR_2A.xpm

WE wall_rendering/FLOOR_2A.xpm

EA wall_rendering/FLOOR_2A.xpm


F 237,241,214
C 237,241,214


11111111111111111111111111111
100010000000000000000000000001
1000100000000000000000000000001
10001000000000000000000000000001
10001100000000000000000000000001
1000000000000000000N00000000000011111111111111111111111
11110100000000000000000000000000001111111011100000010001
1111010000000000000000000000000001111111011101010010001
1100000000000000000000000000000000110101011100000010001
10000000000000000000000000000000000000000001100000010001
10000000000000000000000000000000000000000001101010010001
110000000000000000000000000000000011101010111110111100111
11110100000000000000000000000000001 1110101 101111010001
11111111111111111111111111111111111111111111111111111111