NO wall_rendering/BRICK_3A.xpm

SO wall_rendering/BRICK_3B.xpm



WE wall_rendering/BRICK_3C.xpm
EA wall_rendering/BRICK_3D.xpm

F 128,128,128


C 5,185,206

11111111111111111111111111111111111111111111111111111111111111111111111111111111111111111111111111111111111111111111111111111111111111111111111111111111111111111111111111111111
100000000000000000000000000000000000000000000000000000000000000000000000000000000000000000000000000000000000000000000000000000000000000000000000000000000000000000000000000000001
100000000000000000000000000000000000000000000000000000000000000000000000000000000000000000000000000000000000000000000000000000000000000000000000000000000000000000000000000000001
111111111000000000000000000000000000000000000000000000000000000000000000000000000000000000000000000000000000000000000000000000000000000000000000000000000000000000000000000000001
111111111000000000000000000000000000000000000000000000000000000000000000000000000000000000000000000000000000000000000000000000000000000000000000000000000000000000000000000000001
100000000000000000000000000000000000000000000000000000000000000000000000000000000000000000000000000000000000000000000000000000000000000000000000000000000000000000000000000000011
100000000000000000000000000000000000000000000000000000000000000000000000000000000000000000000000000000000000000000000000000000000000000000000000000000000000000000000000000000011
100000000001111111101111111111111111011000001111111110111111111100001101111111111111111011111111111111110111111111111111101111111111111111011111111111111110111111111111111101111
100000000001111111101111111111111111011000001111111110111111111100001101111111111111111011111111111111110111111111111111101111111111111111011111111111111110111111111111111101111
100000000001000000101000000110000001010000001100000010100000011000000101000000110000001010000001100000010100000011000000101000000110000001010000001100000010100000011000000101001
100000000001000000101000000110000001010000001100000010100000011000000101000000110000001010000001100000010100000011000000101000000110000001010000001100000010100000011000000101001
10000000W00000100000000100000001000000001000000000000000000001001000000001000000010000000010000000100000000100000001000000001000000010000000010000000100000000100000001000000001
100000000000010000100000000000000001000000000000000000000000000000000000000000000000001000000000000000010000000000000000100000000000000001000000000000000010000000000000000100001
100000000001000000101000000110000001010000001100000010100000000000000101000000110000001010000001100000010100000011000000101000000110000001010000001100000010100000011000000101001
100000000001000000101000000110000001010000001100000010100000000000000101000000110000001010000001100000010100000011000000101000000110000001010000001100000010100000011000000101001
100000000001111111101111111111111111011111111111111110111111111111111101111111111111111011111111111111110111111111111111101111111111111111011111111111111110111111111111111101111
1000000000011111111011111111111111110111111111100011101111111111111111011111111111111110111111111111111101111111111111111011111111111111110111111111111111101111111111111111011111
10000000000000000000000000000000000000000000000000000000000000000000000000000000000000000000000000000000000000000000000000000000000000000000000000000000000000000000000000000001
100000000000000000000000000000000000000000000000000000000000000000000000000000000000000000000000000000000000000000000000000000000000000000000000000000000000000000000000000000011
100000000000000000000000000000000000000000000000000000000000000000000000000000000000000000000000000000000000000000000000000000000000000000000000000000000000000000000000000000011
100000000000000000000000000000000000000000000000000000000000000000000000000000000000000000000000000000000000000000000000000000000000000000000000000000000000000000000000000000011
111111111111111111111111111111111111111111111111111111111111111111111111111111111111111111111111111111111111111111111111111111111111111111111111111111111111111111111111111111111