NO wall_rendering/FLOOR_2A.xpm

SO wall_rendering/FLOOR_2A.xpm



WE  wall_rendering/FLOOR_2A.xpm


EA wall_rendering/FLOOR_2A.xpm

F 237,241,02
C 37,241,11


111111111111111111111111111111
101E00000000000000000000000001          
11111111111111111111111111111111111
1